##########
#A       #
#   ### ##
####    B#
#        #
##########
